//MAP CONVERTED BY dmm2tgm.py THIS HEADER COMMENT PREVENTS RECONVERSION, DO NOT REMOVE
"ak" = (
/obj/item/stack/cable_coil/cut/red,
/turf/open/floor/plating/airless,
/area/ruin/space/has_grav/greytidestation/maint)
"av" = (
/obj/structure/lattice,
/turf/open/space,
/area/space)
"aO" = (
/obj/structure/lattice,
/obj/structure/cable{
	icon_state = "1-2"
	},
/turf/open/space,
/area/space)
"aT" = (
/obj/structure/cable,
/turf/open/floor/plating/airless,
/area/ruin/space/has_grav/greytidestation/maint)
"fh" = (
/obj/structure/table,
/obj/item/storage/box/fancy/donut_box,
/turf/open/floor/plating,
/area/ruin/space/has_grav/powered/greytidestation/maint_fort)
"fU" = (
/obj/machinery/iv_drip,
/turf/open/floor/plasteel/airless,
/area/ruin/space/has_grav/greytidestation/medbay)
"gF" = (
/obj/structure/cable{
	icon_state = "2-8"
	},
/obj/structure/cable{
	icon_state = "1-2"
	},
/obj/structure/cable{
	icon_state = "2-4"
	},
/turf/open/floor/plating/airless,
/area/ruin/space/has_grav/greytidestation/maint)
"gK" = (
/obj/item/stack/cable_coil/cut/red,
/turf/open/floor/plating/airless,
/area/ruin/space/has_grav/greytidestation/medbay)
"gS" = (
/turf/closed/wall/r_wall,
/area/ruin/space/has_grav/greytidestation/hallway)
"gX" = (
/obj/structure/cable{
	icon_state = "2-8"
	},
/turf/open/floor/plating/airless,
/area/ruin/space/has_grav/greytidestation/maint)
"hQ" = (
/obj/structure/cable{
	icon_state = "4-8"
	},
/turf/open/floor/plasteel/airless,
/area/ruin/space/has_grav/greytidestation/hallway)
"iK" = (
/turf/open/floor/plating/airless,
/area/ruin/space/has_grav/greytidestation/medbay)
"jq" = (
/obj/structure/table,
/obj/item/clothing/gloves/color/yellow,
/turf/open/floor/plating,
/area/ruin/space/has_grav/powered/greytidestation/maint_fort)
"jE" = (
/obj/structure/rack,
/obj/item/stack/sheet/mineral/uranium,
/turf/open/floor/plating/airless,
/area/ruin/space/has_grav/greytidestation/maint)
"jX" = (
/turf/open/floor/plasteel/airless,
/area/ruin/space/has_grav/greytidestation/chemistry)
"ki" = (
/obj/structure/cable{
	icon_state = "1-4"
	},
/turf/template_noop,
/area/template_noop)
"kI" = (
/turf/open/floor/plating,
/area/ruin/space/has_grav/powered/greytidestation/maint_fort)
"kJ" = (
/obj/structure/lattice,
/obj/structure/cable,
/turf/open/space,
/area/space)
"ll" = (
/obj/machinery/power/apc{
	cell_type = /obj/item/stock_parts/cell/high/empty;
	dir = 1;
	name = "East Maintainance";
	pixel_y = 24
	},
/obj/structure/cable{
	icon_state = "4-8"
	},
/obj/structure/cable{
	icon_state = "0-4"
	},
/turf/open/floor/plating/airless,
/area/ruin/space/has_grav/greytidestation/maint)
"lM" = (
/obj/structure/chair/stool,
/turf/open/floor/plating,
/area/ruin/space/has_grav/powered/greytidestation/maint_fort)
"mn" = (
/obj/structure/cable{
	icon_state = "4-8"
	},
/turf/open/floor/plasteel/airless,
/area/ruin/space/has_grav/greytidestation/chemistry)
"ns" = (
/obj/machinery/door/airlock/maintenance{
	req_access_txt = "12"
	},
/obj/structure/cable{
	icon_state = "1-2"
	},
/turf/open/floor/plating,
/area/ruin/space/has_grav/greytidestation/maint)
"nt" = (
/obj/machinery/chem_dispenser/drinks{
	dir = 8
	},
/turf/open/floor/plating,
/area/ruin/space/has_grav/powered/greytidestation/maint_fort)
"oc" = (
/obj/structure/cable{
	icon_state = "1-2"
	},
/turf/open/floor/plasteel/airless,
/area/ruin/space/has_grav/greytidestation/hallway)
"oh" = (
/obj/structure/cable{
	icon_state = "1-2"
	},
/turf/open/floor/plasteel/airless,
/area/ruin/space/has_grav/greytidestation/medbay)
"oj" = (
/obj/machinery/door/airlock/medical/glass{
	req_access_txt = "12"
	},
/obj/structure/cable{
	icon_state = "1-2"
	},
/turf/open/floor/plasteel/airless,
/area/ruin/space/has_grav/greytidestation/medbay)
"pg" = (
/obj/structure/table,
/obj/item/storage/toolbox/mechanical,
/turf/open/floor/plating,
/area/ruin/space/has_grav/powered/greytidestation/maint_fort)
"pM" = (
/turf/closed/wall/r_wall,
/area/ruin/space/has_grav/greytidestation/chemistry)
"qb" = (
/turf/template_noop,
/area/template_noop)
"qs" = (
/obj/structure/lattice,
/obj/item/stack/cable_coil/cut/red,
/turf/open/space,
/area/space)
"qD" = (
/turf/closed/wall/r_wall,
/area/ruin/space/has_grav/greytidestation/maint)
"qK" = (
/obj/structure/cable{
	icon_state = "1-2"
	},
/obj/structure/cable,
/turf/open/floor/plating/airless,
/area/ruin/space/has_grav/greytidestation/maint)
"rt" = (
/obj/structure/bed,
/obj/effect/decal/cleanable/food/flour,
/obj/item/reagent_containers/food/snacks/egg,
/turf/open/floor/plating,
/area/ruin/space/has_grav/powered/greytidestation/maint_fort)
"uT" = (
/obj/machinery/power/apc{
	cell_type = /obj/item/stock_parts/cell/high/empty;
	dir = 1;
	name = "East Hallway";
	pixel_y = 24
	},
/obj/structure/cable{
	icon_state = "0-4"
	},
/turf/open/floor/plasteel/airless,
/area/ruin/space/has_grav/greytidestation/hallway)
"vm" = (
/obj/machinery/chem_dispenser/drinks/beer{
	dir = 8
	},
/turf/open/floor/plating,
/area/ruin/space/has_grav/powered/greytidestation/maint_fort)
"vN" = (
/obj/structure/cable{
	icon_state = "1-4"
	},
/turf/open/floor/plating,
/area/ruin/space/has_grav/powered/greytidestation/maint_fort)
"vX" = (
/obj/structure/table,
/obj/item/gun/ballistic/shotgun/doublebarrel/improvised,
/turf/open/floor/plating,
/area/ruin/space/has_grav/powered/greytidestation/maint_fort)
"wg" = (
/turf/closed/wall,
/area/ruin/space/has_grav/powered/greytidestation/maint_fort)
"wS" = (
/obj/structure/table,
/obj/item/twohanded/spear,
/turf/open/floor/plating,
/area/ruin/space/has_grav/powered/greytidestation/maint_fort)
"yp" = (
/obj/structure/cable{
	icon_state = "2-8"
	},
/turf/open/floor/plasteel/airless,
/area/ruin/space/has_grav/greytidestation/hallway)
"yC" = (
/obj/structure/cable{
	icon_state = "1-2"
	},
/turf/open/floor/plating/airless,
/area/ruin/space/has_grav/greytidestation/maint)
"AR" = (
/obj/item/storage/box/beakers,
/turf/template_noop,
/area/template_noop)
"Bj" = (
/obj/structure/cable{
	icon_state = "1-4"
	},
/turf/open/floor/plating/airless,
/area/ruin/space/has_grav/greytidestation/maint)
"Cw" = (
/obj/structure/cable{
	icon_state = "4-8"
	},
/turf/open/floor/plating/airless,
/area/ruin/space/has_grav/greytidestation/maint)
"Em" = (
/obj/structure/lattice,
/obj/item/storage/box/beakers,
/turf/open/space,
/area/space)
"Ew" = (
/obj/structure/cable{
	icon_state = "1-2"
	},
/turf/open/floor/plating/airless,
/area/ruin/space/has_grav/greytidestation/medbay)
"EC" = (
/turf/open/floor/plating/airless,
/area/ruin/space/has_grav/greytidestation/maint)
"Fg" = (
/obj/machinery/chem_dispenser,
/turf/open/floor/plasteel/airless,
/area/ruin/space/has_grav/greytidestation/chemistry)
"FV" = (
/obj/structure/cable{
	icon_state = "2-4"
	},
/turf/open/floor/plasteel/airless,
/area/ruin/space/has_grav/greytidestation/medbay)
"Hp" = (
/obj/structure/cable{
	icon_state = "1-2"
	},
/obj/structure/cable{
	icon_state = "1-4"
	},
/turf/open/floor/plasteel/airless,
/area/ruin/space/has_grav/greytidestation/medbay)
"HR" = (
/obj/item/stack/sheet/metal/fifty,
/obj/item/stack/sheet/glass/fifty,
/turf/open/floor/plating,
/area/ruin/space/has_grav/powered/greytidestation/maint_fort)
"HZ" = (
/obj/structure/lattice,
/obj/structure/cable{
	icon_state = "0-8"
	},
/turf/open/space,
/area/space)
"Is" = (
/obj/structure/lattice,
/obj/item/reagent_containers/glass/beaker/large,
/turf/open/space,
/area/space)
"IC" = (
/turf/open/floor/plating/airless,
/area/ruin/space/has_grav/greytidestation/hallway)
"Jb" = (
/obj/structure/lattice,
/obj/structure/cable{
	icon_state = "2-4"
	},
/obj/structure/cable{
	icon_state = "2-8"
	},
/turf/open/space,
/area/space)
"Jc" = (
/turf/open/floor/plasteel/airless,
/area/ruin/space/has_grav/greytidestation/hallway)
"JI" = (
/obj/structure/cable{
	icon_state = "1-8"
	},
/turf/open/floor/plating/airless,
/area/ruin/space/has_grav/greytidestation/medbay)
"KG" = (
/obj/machinery/chem_heater,
/turf/open/floor/plasteel/airless,
/area/ruin/space/has_grav/greytidestation/chemistry)
"Ln" = (
/obj/structure/lattice,
/obj/structure/cable{
	icon_state = "0-2"
	},
/turf/open/space,
/area/space)
"Lp" = (
/turf/closed/wall,
/area/ruin/space/has_grav/greytidestation/hallway)
"LG" = (
/obj/machinery/power/apc{
	dir = 1;
	name = "Fort Assistant Gang";
	pixel_y = 24
	},
/obj/structure/cable{
	icon_state = "0-8"
	},
/turf/open/floor/plating,
/area/ruin/space/has_grav/powered/greytidestation/maint_fort)
"MT" = (
/turf/closed/wall,
/area/ruin/space/has_grav/greytidestation/maint)
"Pu" = (
/obj/structure/chair/stool,
/mob/living/simple_animal/hostile/syndicate/greytide,
/turf/open/floor/plating,
/area/ruin/space/has_grav/powered/greytidestation/maint_fort)
"PQ" = (
/obj/structure/table,
/obj/item/storage/belt/utility/full/engi,
/turf/open/floor/plating,
/area/ruin/space/has_grav/powered/greytidestation/maint_fort)
"Qc" = (
/obj/structure/cable{
	icon_state = "1-8"
	},
/turf/open/floor/plasteel/airless,
/area/ruin/space/has_grav/greytidestation/medbay)
"Qk" = (
/obj/structure/cable{
	icon_state = "2-8"
	},
/turf/open/floor/plating/airless,
/area/ruin/space/has_grav/greytidestation/chemistry)
"Rg" = (
/obj/structure/table,
/obj/item/paper,
/turf/open/floor/plating,
/area/ruin/space/has_grav/powered/greytidestation/maint_fort)
"Rp" = (
/obj/machinery/door/airlock/maintenance{
	req_access_txt = "12"
	},
/obj/structure/cable{
	icon_state = "1-2"
	},
/turf/open/floor/plating/airless,
/area/ruin/space/has_grav/greytidestation/hallway)
"Sy" = (
/obj/structure/cable{
	icon_state = "4-8"
	},
/turf/open/floor/plating/airless,
/area/ruin/space/has_grav/greytidestation/medbay)
"Tq" = (
/obj/structure/bed/roller,
/turf/open/floor/plasteel/airless,
/area/ruin/space/has_grav/greytidestation/medbay)
"Ut" = (
/obj/machinery/chem_master,
/obj/item/reagent_containers/glass/beaker/large,
/turf/open/floor/plasteel/airless,
/area/ruin/space/has_grav/greytidestation/chemistry)
"UJ" = (
/obj/machinery/power/apc{
	cell_type = /obj/item/stock_parts/cell/uhigh/empty;
	dir = 1;
	name = "Medbay";
	pixel_y = 24
	},
/obj/structure/cable{
	icon_state = "0-2"
	},
/turf/open/floor/plasteel/airless,
/area/ruin/space/has_grav/greytidestation/medbay)
"Vl" = (
/obj/machinery/power/port_gen/pacman/super,
/turf/open/floor/plating/airless,
/area/ruin/space/has_grav/greytidestation/maint)
"Vq" = (
/obj/structure/lattice,
/obj/structure/lattice,
/turf/open/space,
/area/space)
"Wl" = (
/obj/structure/cable{
	icon_state = "1-8"
	},
/obj/structure/cable{
	icon_state = "1-2"
	},
/turf/open/floor/plating/airless,
/area/ruin/space/has_grav/greytidestation/medbay)
"Wr" = (
/obj/structure/lattice,
/obj/structure/cable{
	icon_state = "2-8"
	},
/turf/open/space,
/area/space)
"XG" = (
/obj/structure/lattice,
/turf/closed/wall,
/area/ruin/space/has_grav/greytidestation/maint)
"Yh" = (
/obj/machinery/power/apc{
	cell_type = /obj/item/stock_parts/cell/high/empty;
	name = "Chemistry";
	pixel_y = -24
	},
/obj/structure/cable{
	icon_state = "0-4"
	},
/turf/open/floor/plasteel/airless,
/area/ruin/space/has_grav/greytidestation/chemistry)
"Yv" = (
/obj/structure/table,
/obj/item/stack/cable_coil/red,
/turf/open/floor/plating,
/area/ruin/space/has_grav/powered/greytidestation/maint_fort)
"ZL" = (
/turf/open/floor/plating/airless,
/area/ruin/space/has_grav/greytidestation/chemistry)
"ZN" = (
/obj/machinery/sleeper{
	dir = 4
	},
/turf/open/floor/plasteel/airless,
/area/ruin/space/has_grav/greytidestation/medbay)
"ZO" = (
/obj/structure/table,
/obj/item/multitool,
/turf/open/floor/plating,
/area/ruin/space/has_grav/powered/greytidestation/maint_fort)
"ZV" = (
/obj/structure/cable{
	icon_state = "2-4"
	},
/obj/structure/cable{
	icon_state = "1-2"
	},
/turf/open/floor/plasteel/airless,
/area/ruin/space/has_grav/greytidestation/medbay)

(1,1,1) = {"
qb
Ln
qs
aO
qs
aO
ki
EC
av
qb
av
EC
av
av
EC
qb
"}
(2,1,1) = {"
av
av
IC
IC
IC
IC
Jb
yC
yC
yC
yC
yC
ak
qK
av
aT
"}
(3,1,1) = {"
qb
Lp
Jc
Jc
Jc
MT
Cw
wg
wg
wg
wg
wg
wg
wg
EC
EC
"}
(4,1,1) = {"
qb
Lp
uT
Jc
Jc
XG
ll
wg
Pu
Yv
ZO
Pu
PQ
wg
Vl
EC
"}
(5,1,1) = {"
qb
Lp
hQ
Jc
Jc
MT
Cw
wg
Pu
Rg
fh
lM
pg
wg
jE
av
"}
(6,1,1) = {"
qb
Lp
yp
oc
oc
Rp
gF
ns
vN
Pu
lM
kI
wS
wg
EC
av
"}
(7,1,1) = {"
qb
Lp
Jc
Jc
Jc
MT
Cw
wg
LG
kI
kI
kI
vX
wg
EC
EC
"}
(8,1,1) = {"
qb
av
IC
gS
gS
qD
Cw
wg
rt
HR
nt
vm
jq
wg
EC
av
"}
(9,1,1) = {"
qb
qb
Em
ZL
Ut
qD
ak
wg
wg
wg
wg
wg
wg
wg
EC
av
"}
(10,1,1) = {"
qb
av
ZL
jX
KG
qD
gX
yC
yC
yC
yC
yC
Bj
EC
EC
av
"}
(11,1,1) = {"
qb
Is
ZL
jX
Fg
pM
qD
qD
qD
qD
qD
EC
Cw
av
av
av
"}
(12,1,1) = {"
qb
qb
av
jX
Yh
pM
Tq
ZN
ZN
Tq
fU
av
Sy
av
av
qb
"}
(13,1,1) = {"
qb
qb
av
av
mn
pM
UJ
ZV
oh
oh
Hp
oh
Wl
qs
qb
qb
"}
(14,1,1) = {"
AR
qb
qb
Is
Qk
oj
Ew
JI
av
FV
Qc
iK
iK
Wr
kJ
qb
"}
(15,1,1) = {"
qb
qb
qb
qb
av
av
av
av
iK
gK
iK
iK
av
av
qb
qb
"}
(16,1,1) = {"
qb
qb
qb
qb
av
qb
qb
qb
av
HZ
Vq
Vq
qb
av
av
qb
"}
